CameraType,,,,,
1,,,,,
,,,,,
Layer1,,,,,
3,3,3,3,3,3
3,3,3,3,3,3
3,3,3,3,3,3
3,3,3,3,3,3
3,3,3,3,6,3
,,,,,
,,,,,
,,,,,
,,,,,
Layer2,,,,,
0,5,0,0,5,4
5,0,5,5,0,5
0,5,0,0,5,0
0,0,5,5,0,0
0,7,4,4,0,0
,,,,,
,,,,,
,,,,,
,,,,,
Spawn,,,,,
1,0,0,0,0,2
0,0,0,0,0,0
0,0,0,0,0,0
0,0,0,0,0,0
0,0,0,0,0,0