CameraType,,,,,
0,,,,,
,,,,,
Layer1,,,,,,,
3,3,3,3,3,3,3,6
3,3,3,3,3,3,3,3
3,3,3,3,3,3,3,3
3,3,3,3,3,3,3,3
3,3,3,3,3,3,3,3
3,3,3,3,3,3,3,3
,,,,,,,
,,,,,,,
,,,,,,,
Layer2,,,,,,,
0,0,0,0,0,0,0,0
0,0,4,10,4,0,0,0
0,0,4,11,4,0,0,0
0,5,0,0,0,0,5,0
0,4,8,0,4,0,4,4
0,4,9,0,0,0,0,7
,,,,,,,
,,,,,,,
,,,,,,,
Spawn,,,,,,,
0,0,0,0,0,0,0,0
0,0,0,0,0,0,0,0
0,0,0,0,0,0,0,0
0,0,0,0,0,0,0,0
0,0,0,0,0,0,0,0
1,2,0,0,0,0,0,0