CameraType,,,,,
0,,,,,
,,,,,
Layer1,,,,,,,
3,3,3,3,3,3,3,3
3,3,10,3,3,3,3,3
3,3,3,3,3,3,3,3
3,3,3,3,3,3,3,3
3,3,3,3,3,10,3,3
3,3,3,3,3,10,3,3
,,,,,,,
,,,,,,,
,,,,,,,
Layer2,,,,,,,
0,0,0,0,0,0,0,0
0,0,0,0,0,0,0,0
0,0,0,0,0,0,0,0
0,8,4,4,0,0,0,0
4,4,4,4,0,0,0,0
4,4,4,4,0,0,0,0
,,,,,,,
,,,,,,,
,,,,,,,
Spawn,,,,,,,
0,0,0,0,0,0,0,0
0,1,0,0,0,0,0,0
0,0,0,0,0,0,0,0
0,0,0,0,0,0,0,0
0,2,0,0,0,0,0,0
0,0,0,0,0,0,0,0