Layer1,,,,,,,
3,3,3,3,3,3,3,3
3,3,3,3,3,3,3,3
3,3,3,3,3,3,3,6
3,3,3,3,3,3,3,3
3,3,3,3,3,3,3,3
3,3,3,3,3,3,3,3
,,,,,,,
,,,,,,,
,,,,,,,
Layer2,,,,,,,
4,7,0,0,0,0,0,0
4,0,0,0,0,5,0,0
4,0,0,5,0,0,0,0
4,0,0,5,0,0,0,0
4,0,0,0,0,5,0,0
4,4,0,0,0,0,0,0
,,,,,,,
,,,,,,,
,,,,,,,
Spawn,,,,,,,
0,0,0,0,0,0,0,0
0,0,0,0,0,0,0,0
0,1,0,0,0,0,0,0
0,0,0,0,0,0,0,0
0,0,0,0,0,0,0,0
2,0,0,0,0,0,0,0