Layer1,,,,,,,
3,3,3,3,3,3,3,3
3,3,3,3,3,3,3,3
3,3,3,3,3,3,3,3
3,3,3,3,3,3,3,3
3,3,3,3,3,3,3,3
3,3,3,3,3,3,3,6
,,,,,,,
,,,,,,,
,,,,,,,
Layer2,,,,,,,4
0,4,0,4,0,4,0,0
0,0,0,0,5,0,0,0
0,4,0,4,0,4,0,4
0,0,5,0,5,0,5,0
5,4,0,4,0,4,0,4
4,5,0,0,0,7,0,0
,,,,,,,
,,,,,,,
,,,,,,,
Spawn,,,,,,,
1,0,0,0,0,0,0,0
0,0,0,0,0,0,0,0
0,0,0,0,0,0,0,0
0,0,0,0,0,0,0,0
0,0,0,0,0,0,0,0
2,0,0,0,0,0,0,0