CameraType,,,,
3,,,,
,,,,
Layer1,,,,
3,3,3,3,3
3,3,3,3,3
3,3,3,3,6
3,3,3,3,3
3,3,3,3,3
,,,,
,,,,
,,,,
,,,,
Layer2,,,,
4,0,4,0,4
0,0,0,0,0
0,5,5,5,0
0,0,0,0,0
4,0,7,0,4
,,,,
,,,,
,,,,
,,,,
Spawn,,,,
0,0,2,0,0
0,0,0,0,0
1,0,0,0,0
0,0,0,0,0
0,0,0,0,0